10 10
a a a a a a a a a a
a b b b b b b b b a
a b a a a a a a b a
a b a c c c c a b a
a b a c a a c a b a
a b a c a a c a b a
a b a c c c c a b a
a b a a a a a a b a
a b b b b b b b b a
a a a a a a a a a a
